10 10 summer
3 11 11 11 11 11 11 11 11 10
6 340 340 340 340 340 344 340 340 6
6 340 340 340 340 340 340 340 340 6
6 340 340 269 277 278 261 340 340 6
6 340 340 274 328 318 264 340 340 6
6 340 340 274 319 327 265 340 340 6
6 340 340 257 259 259 254 340 340 6
6 340 340 340 340 340 340 340 340 6
6 340 340 340 340 340 340 347 340 6
7 12 12 12 12 12 12 12 12 14
